rows 50
cols 50
players 2
m ...............%%%...............%.......%%%%.%%%.
m .................................%...%%%%%%.......
m .................................%%...%%%%%%%%....
m ......%%%..............................%%%%%.%%...
m .......%%..............................%..%%.%%...
m ......%%%.%%.....%%..........................%%...
m .%....%....%....%%%%.%%%%.................%.....%%
m %%..............%%%%..%%%................%%......%
m ................%%%...%%%.................%.......
m ...%%%..........%%%..%%%%................%%.......
m ..%%%...%%.......%%.%%%%%...%%...........%%.......
m ...%.............%...%%%%.................%.%%....
m %..............%%%...%%%%%............%.....%...%%
m %.%........%........%%%%%%%.....%.....%..........%
m %%%........%.......%%%%%.%%.....%%....%.%%........
m ..................%%%.%%.%%%%%..%%..%...%%%.......
m ..............%..%..................%...%%%....%.%
m %...........%%%%%%..................%..%%%.....%%%
m %%............%%%%%%................%%%%%%......%%
m %..............%%%%%..................%%%%........
m ...............%%%%%..................%%%.........
m ................%%%...................%%%..%%%....
m ................%%%....................%%.%%%%....
m .................%%%.%%%%.................%%%%....
m .0...............%%%.%%%%%.............%%%%%%.....
m ........%.......%%%%.%%%................%%%.......
m ........%...%%%%%%................................
m ........%%...%%%%%%%%.............................
m ..............%%%%%.%%.........%%%................
m ..............%..%%.%%..........%%................
m ....................%%.........%%%.%%.....%%......
m .................%.....%%.%....%....%....%%%%.%%%%
m ................%%......%%%..............%%%%..%%%
m .................%.......................%%%...%%%
m ................%%..........%%%..........%%%..%%%%
m ...%%...........%%.........%%%...%%.......%%.%%%%%
m .................%.%%.......%.............%...%%%%
m %............%.....%...%%%..............%%%...%%%%
m %%.....%.....%..........%%.%........%........%%%%%
m %%.....%%....%.%%........%%%........%.......%%%%%.
m %%%%%..%%..%...%%%.........................%%%.%%.
m ...........%...%%%....%.%..............%..%.......
m ...........%..%%%.....%%%%...........%%%%%%.......
m ...........%%%%%%......%%%%............%%%%%%.....
m .............%%%%........%..............%%%%%.....
m .............%%%........................%%%%%.....
m .............%%%..%%%....................%%%......
m ..............%%.%%%%....................%%%......
m .................%%%%.....................%%%.%%%%
m %.............%%%%%%......1...............%%%.%%%%
